ABB	Thomas.hackman@fi.abb.com	www.abb.com/marine
ABEKING & RASMUSSEN SCHIFFS – UND YACHTWERFT SE	info@abeking.com 	www.abeking.com
ACQUA DELL’ELBA	info@acquadellelba.it 	www.acquadellelba.it
ADEUM CINEMA SUITE	info@adeumcinema.com 	www.adeumcinema.com
ADRIEN MARCOS	adrienmarcos@hotmail.fr 	www.adrienmarcos.com
AEGEAN YACHT	dfne@aegeanyacht.com 	www.aegeanyacht.com
AFFINITY MANAGEMENT SERVICES	info@affinity.co.im  	 	www.affinity.co.im
AGC MARINE TELECOM	info@agcmarine.com 	www.agcmarine.com
AGL MARINE	aglmarine@agl-marine.com	www.agl-marine.com
ALAPE	mail@dornbrachtgroup.fr 	www.alape.com
ALEN YACHT	alp@alenyacht.com 	www.alenyacht.com
ALEWIJNSE MARINE	info@alewijnse.com  	 	www.alewijnse.com
ALEXSEAL YACHT COATINGS	info@alexseal.com	 	www.alexseal.com
AMELS	info@amels-holland.com 	www.amels-holland.com
AMICO & CO	technical.sales@amicoshipyard.com 	www.amicoshipyard.com
AMPERAUTO	info@amperauto.com 	www.amperauto.com
ANP YACHT INSURANCE	plaisance@harrel-courtes.fr 	www.harrelcourtes.fr
ANTIGUA CHARTER YACHT SHOW	acym@apuainet.ag	www.antiguayachtshow.com
ANVERA	info@anvera.it  	www.anvera.it
API – PROTECTIVE COATING AND RESIN FLOORING	api@api-spa.com 	www.api-spa.com
AQUA MARINE YACHT	nicolasbochno@aquamarine.fr    	www.aquamarine.fr
AQUN	info@aqun.world 	www.aqun.world
ARABIAN KNIGHT	post@crescentpublishing.co.uk	www.arabianknightonline.com
ARCADIA YACHTS	info@arcadiayachts.it 	www.arcadiayachts.it
ARCON YACHTS	info@arconyachts.com 	www.arconyachts.com
ARES DESIGN MODENA	info@aresdesign.com 	www.aresdesign.com
ARROW SERVICES MONACO	info@arrowyacht.com 	www.arrowyacht.com
ARTIFACT NEW YORK	info@artifactnyc.net 	www.artifactnyc.net
ASCOM SPA	info@ascom-italy.it 	www.ascom-italy.it
ASCOMA MARITIME INSURANCE	maritime@ascoma.com 	www.ascoma-maritime.com
ASEA POWER SYSTEMS	briang@mce-llc.com	www.aseapower.com
ASIA PACIFIC SUPERYACHTS	gordon@asia-pacific-superyachts.com 	www.asia-pacific-superyachts.com
ASIA-PACIFIC BOATING	sharonh@bluincmedia.com 	www.bluincmedia.com
ASTILLEROS DE MALLORCA	info@astillerosdemallorca.com 	www.astillerosdemallorca.com
ATALANTE	info@groupeatalante.com 	www.groupeatalante.com
ATELIER BERNARD PICTET	B.P@bernardpictet.com 	www.bernardpictet.com
ATLAS CARBON PRODUCTS	tony@atlascarbonproducts.com 	www.atlascarbonproducts.com
ATLAS MARINE SYSTEMS	sales@atlasmarinesystems.com 	www.atlasmarinesystems.com
AUTRONICA FIRE & SECURITY AS	sales.maritime@autronicafire.com 	www.autronicafire.com
AVON MARINE	antoine.hebersuffrin@znautigroup.com	    www.avonmarine.com
AWLGRIP EUROPE	awlgrip.eu@akzonobel.com	 	www.awlgrip.com
AXXESS MARINE	support@axxess-marine.com 	www.axxess-marine.com
AZIMUT YACHTS	customercare@azimutbenettigroup.com   www.azimutyachts.com
AZURE YACHT DESIGN & NAVAL ARCHITECTURE	info@azure-na.com 	www.azure-na.com
BAGLIETTO S.P.A.	marketing@baglietto.com 	www.baglietto.com
BALEARIC YACHT DESTINATION	maria@balearicyachtdestination.com 	www.balearicyachtdestination.com
BALK SHIPYARD	info@balkshipyard.com 	www.balkshipyard.com
BALTIC YACHTS	info@balticyachts.fi 	www.balticyachts.fi
BARRACUDA YACHT DESIGN	i.toledo@barracuda-yd.com 	www.barracuda-yd.com
BAUDOIN OCEAN WASH-SYSTEMS	joost@baudoin.nl 	www.baudoin.com
BCM ILLUMINAZIONE SRL	info@bcmilluminazione.com 	www.bcmilluminazione.com
BELL	kallison@bellflight.com 	www.bellflight.com
BENETTI	info@benettiyachts.it 	www.benettiyachts.it
BERNICO	info@bernico.be 	www.bernico.be
BERRET-RACOUPEAU YACHT DESIGN	info@berret-racoupeau.com 	www.berret-racoupeau.com
BESENZONI SPA	info@besenzoni.it 	www.besenzoni.it
BLUEGAME	info@bluegame.it 	www.bluegame.it
BLUEWATER	info@bluewateryachting.com 	www.bluewateryachting.com
BOAT EXCLUSIVE	info@delius-klasing.de 	www.delius-klasing.de
BOAT INTERNATIONAL	info@boatinternational.com 	www.boatinternational.com
BOAT INTERNATIONAL US	www.boatinternationalmedia.com
BOAT LIFT	info@boatlift.it 	www.boatlift.it
BOBIC YACHT INTERIOR	info@bobic.eu 	www.bobic.eu
BOERO YACHTCOATINGS	l.serventi@boero.it	www.boeroyachtcoatings.com
BOLIDT SYNTHETIC PRODUCTS & SYSTEMS	maritime@bolidt.com 	www.bolidt.com/en/super-yachts
BOND TECHNOLOGY MANAGEMENT	info@bondtm.com 	www.bondtm.com
BOOTE EXCLUSIV	exclusiv@boote-exclusiv.com 	www.boote-exclusiv.com
BORDEAUX SUPERYACHTS PORT OF CALL & REFIT   cdm@bordeaux-superyachts-refit.fr 	  www.bordeaux-superyachts-refit.fr
BRABUS	Daniel.krone@gmx.net	www.brabus.com
BUMAT	sales@bumat.com 	www.bumat.com
BUREAU VERITAS	veristarinfo@bureauveritas.com  	www.bureauveritas.com
BURGESS	London@burgessyachts.com	www.burgessyachts.com
CADORIN GROUP SRL	info@cadoringroup.it 	www.cadoringroup.it
CALA DEL FORTE	sales@caladelforte-ventimiglia.it 	www.caladelforte-ventimiglia.it
CAM GROUP – CONSORZIO ADRIATICO MONTAGGI	info@camweb.it	www.consorzioadriaticomontaggi.it
CAMPER & NICHOLSONS INTERNATIONAL	monaco@camperandnicholsons.com 	www.camperandnicholsons.com
CANTALUPI LIGHTING SRL	info@cantalupilighting.it	 	www.cantalupilighting.it
CANTIERE NAUTICO CRANCHI	sales@cranchi.it	www.cranchi.com
CAPAX MARINE ENGINEERING	drago@capax.hr 	www.capax.hr
CASTOLDI S.R.L.	info@castoldijet.it 	www.castoldijet.it
CASTOR MARINE	request@castormarine.com 	www.castornetworks.com
CATERPILLAR INC.	quick_kate@cat.com 	www.cat.com
CATHELCO	sales@cathelco.com 	www.cathelco.com
CAYMAN ISLANDS SHIPPING REGISTRY	nancy.bodden@cishipping.com 	www.cishipping.com
CBI NAVI	info@gpyachts.it 	www.gpyachts.it
CCN – CERRI CANTIERI NAVALI	info@cerricantierinavali.it 	www.cerricantierinavali.it
CECIL WRIGHT & PARTNERS	www.cecilwright.com
CHAMPAGNES LANSON	cdardenne@l-i-d.com	www.lanson.com
CHARTCo	chris.warde@chartco.com 	www.chartco.com
CHI DESIGN	info@chi-design.it 	www.chi-design.it
CHRISTOPHE HARBOUR	info@christopheharbour.com 	www.christopheharbour.com
CIMOLAI TECHNOLOGY SPA	info@cimolaitechnology.com 	www.cimolaitechnology.com
CMC MARINE SRL	info@cmcmarine.com 	www.cmcmarine.com
CNM – CANTIERI NAVALI DEL MEDITERRANEO	info@cnmspa.com 	www.cnmspa.com
COBHAM SATCOM	info@messales.it	www.cobham.com
COCKWELLS	info@cockwells.co.uk 	www.cockwells.co.uk
COLUMBUS YACHTS	info@columbusyachts.com 	www.columbusyachts.com
COMILEGNO SRL	info@comilegno.com 	www.comilegno.com
COMPAGNIA GENERALE TELEMAR SPA	p.tagliapietra@cgtelemar.com 	www.telemarspa.it
COMPASS TENDERS	info@compasstenders.com 	www.compasstenders.com
CONDARIA 87 SRL	customersupportcenter@dometic.com	www.condaria.com
CONRAD S.A.	conrad@conradshipyard.com 	www.conradshipyard.com
COR D. ROVER DESIGN	cor@cor-d-rover.com 	www.cor-d-rover.com
COTE MAGAZINE	cote@cotemagazine.com 	www.cotemagazine.com
COUACH	info@couach.com 	www.couach.com
COX POWERTRAIN	commercial@coxpowertrain.com	www.coxmarine.com
CRAMM YACHTING SYSTEMS	info@cramm.nl	www.cramm-yachting-systems.com
CREDIT SUISSE AG	aviation.finance@credit-suisse.com 	www.credit-suisse.com
CRESTRON	ppini@crestron.eu 	www.crestron.com
CRN SHIPYARD	info@crn-yacht.com 	www.crn-yacht.com
CRYSTAL CAVIAR	info@crystalcaviar.eu 	www.crystalcaviar.eu
CUMMINS LTD	emea.customerassistance@cummins.com       www.cumminsengines.com
CURRENT CORPORATION	bianca@currentcorp.com 	www.currentcorp.com
D. KORONAKIS SA	mgerolymatou@koronakis.gr 	www.koronakis.gr
DAMEN	info@yacht-support.nl 	www.yacht-support.nl
DANIELE DE WINTER	boutique@danieledewinter.com 	www.danieledewinter.com
DANTON ARTS KUSTOMS	contact@danton-arts-kustoms.com 	www.danton-arts-kustoms.com
DARIEL	amministrazione@darielyacht.com 	www.darielyacht.com
DARNET DESIGN	cecile@franck-darnet-design.com  	www.darnet-design.com
DASSAULT AVIATION	frederic.wallois@dassault-aviation.com   www.dassault-aviation.com
DEEP BLUE SOFT FRANCE	dbs-contact@deepbluesw.com 	www.deepbluesw.com
DEEP TREKKER	sales@deeptrekker.com 	www.deeptrekker.com
DEIF MEDITERRANEA	mediterranea@deif.com 	www.deif.com
DEK-KING	chris@wilks.co.uk	www.dek-king.com
DELTA MARINE	delta@deltamarine.com 	www.deltamarine.com
DELTA POWERBOATS	kalle@deltapowerboats.se 	www.deltapowerboats.se
DEUTSCHE YACHTEN	meyer@dbsv.de	www.deutsche-yachten.de
DGI SYPACK	info@dgi-doedijns.com	www.dgi-company.com
DIXON YACHT DESIGN	bill@dixonyachtdesign.com 	www.dixonyachtdesign.com
D-MARIN	info@d-marin.com 	www.d-marin.com
DOCKWALK MAGAZINE	enquiries@boatinternationalmedia.com       www.dockwalk.com
DOEHLE YACHTS	rquayle@dohle-yachts.com 	www.dohle-yachts.com
DOMINATOR YACHTS	info@dominator.li 	    	www.dominatorychts.com
DOMINION GROUP LIMITED	rob@dominionmarine.com 	www.dominionmarine.com
DORNBRACHT	mbellenger@dornbracht.fr 	www.dornbracht.com
DOWN UNDER REFIT & REPAIR: DESTINATION AUSTRALIA    medwards@aimex.asn.au     www.superyacht-australia.com
DOYLE SAILS	communications@doylesails.com 	www.doylesails.com
DYKSTRA NAVAL ARCHITECTS	anneliek@dykstra-na.nl 	www.dykstra-na.nl
DYT YACHT TRANSPORT	info@yacht-transport.com 	www.yacht-transport.com
E3 SYSTEMS	info@e3s.com 	www.e3s.com
EASTWIND YACHTS	office@eastwindyachts.com 	www.eastwindyachts.com
EDMISTON	cvg@edmiston.com 	www.edmiston.com
EEKELS MARPOWER	m.lammers@eekels.com	www.marpower.nl
ELITE LIVING AFRICA	roman.zincenko@alaincharles.com	www.elitelivingafrica.com
ELITE MARINE SOLUTIONS LIMITED	hello@elitemarine.uk 	www.elitemarinesolutions.com
ENGEL & VOELKERS YACHTING FRENCH RIVIERA	   frenchrivierayachting@engelvoelkers.com   www.engelvoelkers.com/en-fr/frenchrivierayachting
EQUIOM YACHTING	enquiries@equiomgroup.com 	www.equiomgroup.com
ESTHEC COMPOSITE DECKING	info@esthec.com 	www.esthec.com
EVAC OY	evac.marine@evac.com 	www.evac.com/yacht
EVADNE YACHTS	contact@evadneyachts.com 	www.evadneyachts.com
EXMAR YACHTING	contact@exmaryachting.com 	www.exmaryachting.com
F.LLI GIOVANARDI	info@giovanardi.it 	www.giovanardi.it
FAIRMONT MONTE CARLO	clemence.antonie@fairmont.com 	www.fairmont.com/montecarlo
FARSOUNDER	info@farsounder.com 	www.farsounder.com
FEADSHIP	info@feadship.nl 	www.feadship.nl
FEDERATION DES INDUSTRIES NAUTIQUES	eric.mabo@fin.fr	www.industriesnautiques.fr
FENDEQUIP MOORING PRODUCTS	paul@fendequip.com 	www.fendequip.com
FERRETTI GROUP	ferrettigroup@ferrettigroup.com 	www.ferrettigroup.com
FINCANTIERI YACHTS	fincantieriyachts@fincantieri.it	 	www.fincantieriyachts.it
FINKELDEI POLSTERMOEBELMANUFAKTUR	info@finkeldei.com	www.siebensee.com
F JORD	info@fjordboats.com 	www.fjordboats.com
FLEXITEEK SUPER YACHT LTD	rob@flexiteek.co.uk 	www.flexiteek.com
FLIR SYSTEMS	hans.groenenboom@flir.com 	www.flir.com
FLOATING LIFE	events@floatinglife.com 	www.floatinglife.com
FOGLIZZO LEATHER S.R.L.	marco@foglizzo.com 	www.foglizzo.com
FRAMES & DESIGN	maxime.bensadoun@framesanddesign.fr    www.framesanddesign.fr
FRANCE HOME TO SUPERYACHTING	contact@rynetwork.com	www.riviera-yachting-network.fr
FRASER	Monaco@fraseryachts.com 	www.fraseryachts.com
FRERS DESIGN	frers@frers.design 	www.frers.design
FRIGOMAR	frigomar@frigomar.com 	www.frigomar.com
FRIGONAUTICA	info@frigonautica.it 	www.frigonautica.it
FUCHS FOERDERTECHNIK AG	info@fuchs-cranes.de 	www.fuchs-cranes.de
FUNAIR	john@funair.com 	www.funair.com
FURUNO ELECTRIC CO	sales@furuno.it 	www.furuno.com
GEO. GLEISTEIN & SOHN GMBH	giese-bothe@gleistein.com 	www.gleistein.com
GIANNESCHI PUMPS & BLOWERS	info@gianneschi.net 	www.gianneschi.info
GIBRALTAR MARITIME	diana.soussi@gibraltar.gov.gi 	www.gibraltaryacht.com
GINTON NAVAL ARCHITECTS	info@ginton.com 	www.ginton.com
GL EVENTS	www.gl-events.com
GL YACHTVERGLASUNG	service@gl-yv.de 	www.gl-yv.de
GLOBAL SATELLITE USA, LLC	ap@globalsatellite.us 	www.globalsatellite.us
GLYN PETER MACHIN	gpm@glynpetermachin.com 	www.glynpetermachin.com
GORDON & GAIEA	gordon@gordon-gaia.com 	www.gordon-gaia.com
GOTTIFREDI MAFFIOLI SRL	gm@gottifredimaffioli.com 	www.gottifredimaffioli.com
GREENLINE MONACO	losttoysmaritime@gmail.com	www.greenlinehybrid.si
GREENLINE YACHT INTERIORS	info@glyi.ae 	www.glyi.net
G-YACHTS	info@g-yachts.com 	www.g-yachts.com
HAKVOORT SHIPYARD	sales@hakvoort.com 	www.hakvoort.com
HALYARD (M+l) LTD	technical@halyard.eu.com 	www.halyard.eu.com
HAMANN AG	rtietje@hamannag.com 	www.hamannag.com
HANTANG CULTURE	miaoxiaolin@acmedynasty.com 	www.acmedynasty.com
HARKEN	harken@harken.com 	www.harken.com
HEADHUNTER	headmaster@headhunterinc.com	www.headhunterinc.com
HEESEN YACHTS	sales@heesenyachts.com 	www.heesenyachts.com
HEINEN & HOPMAN	info@heinenhopman.com 	www.heinenhopman.com
HEIRLOOMS LINENS	ruth@heirlooms-linens.com 	www.heirlooms-superyachts.com
HGH INFRARED SYSTEMS	hgh@hgh.fr	www.hgh-infrared.com
HIGHLAND WIRELESS SERVICES	info@highlandwireless.com 	www.highlandwireless.com
HILL ROBINSON YACHT MANAGEMENT	mariska@hillrobinson.com 	www.hillrobinson.com
HISWA HOLLAND YACHTING GROUP	info@hollandyachtinggroup.com 	www.hollandyachtinggroup.com
HOEK DESIGN NAVAL ARCHITECTS	info@hoekdesign.com 	www.hoekdesign.com
HORIZON	info@horizonyachteurope.com 	www.horizonyacht.com
HUG ENGINEERING AG	info.ch@hug-engineering.com 	www.hug-engineering.com
HUISMAN ETECH YACHT SERVICES SARL	service@huismanetech.com 	www.huismanetech.com
HYDROMAR MARINE EQUIPMENT B.V.	info@hydromar.nl 	www.info@hydromar.nl
ICON YACHTS	sales@iconyachts.eu	www.iconyachts.eu
IDEA DATA SOLUTIONS GMBH	info@idea-yacht.com 	www.idea-yacht.com
IDROMAR WATERMAKERS	info@idromar.tv 	www.idromar.tv
IL NORMANNO	info@normanno.it 	www.normanno.it
IMPERIAL YACHTS	monaco@imperial-yachts.com 	www.imperial-yachts.com
IMS SHIPYARD	a.deberdt@ims-shipyard.com 	www.ims-shipyard.com
INDIAN OCEAN	eurosales@indian-ocean.co.uk 	www.indian-ocean.co.uk
INTERIOR DESIGN FACTORY	christine@interior-design-factory.com  	www.interior-design-factory.com
ISA YACHTS	info@isayachts.com 	www.isayachts.com
ISLE OF MAN SHIP AND YACHT REGISTRIES	cameron.mitchell@gov.im	www.iomshipregistry.com
ISOCLIMA	marketing@isoclimagroup.com 	www.isoclimagroup.com
ITALWINCH BY ORVEA	info@mzelectronic.it 	www.mzelectronic.it
 IYC	monaco@iyc.com 	www.iyc.com
JALLU EBENISTES	mail@yannjallu.net 	www.yannjallu.net
JET ASIA-PACIFIC 	queries@bluincmedia.com	www.jetasiapacific.com
JETCRAFT	info@jetcraft.com  	www.jetcraft.com
JFA YACHTS	jfa@jfa-yachts.com 	www.jfa-yachts.com
JONGERT BV	info@jongert.nl 	www.jongert.nl
JOTUN AIS	marcus.reynolds@jotun.com 	www.jotun.com
JOUFFRE	harles@jouffre.com 	www.jouffre.com
JPMA/HOYLAKE SAILING SCHOOL	reception@hss.ac.uk	www.sailorsworld.co.uk
JUDEL / VROLIJK & CO DESIGN + ENGINEERING GMBH	info@judel-vrolijk.com 	www.judel-vrolijk.com
K1 BRITANNIA TRUST	www.k1britannia.org
KEYSTONE LAW	Kristina.oliver@keystonelaw.co.uk 	www.keystonelaw.co.uk
KK SUPERYACHTS	info@kk-superyachts.com 	www.kk-superyachts.com
KNOX HOUSE MARINE & AVIATION	enquiries@khtlimited.com	www.knoxhousetrust.com
KOHLER	www.kohlerpower.com
KONGSBERG MARITIME	km.sales@kongsberg.com 	www.km.kongsberg.com
KUSCH YACHTS	info@kusch-yachts.com 	www.kusch-yachts.com
KWASNY CARVINGS INTERNATIONAL	info@kwasnycarvings.com 	www.kwasnycarvings.com
L3 MAPPS LIMITED	nigel.dolan@l3t.com	www.l-3marinesystems.com.uk
LAMDA FLISVOS MARINA S.A.	info@flisvosmarina.com 	www.flisvosmarina.com
LAMELLUX	info@lamellux.com 	www.lamellux.com
LANG INTERIEUR MANUFAKTUR	henrik-lang@t-online.de	www.henrik-lang.de
LANKA MARINE	info@lankamarine.it 	www.lankamarine.it
LATERAL NAVAL ARCHITECTS LTD	ask@lateral.engineering 	www.lateral.engineering
LATITUDE YACHT	info@latitude-yachts.com 	www.latitude-yachts.com
LEERDAM PROJECTEN B.V.	arjan@leerdamprojecten.nl 	www.leerdamprojecten.nl
LEONARDO	info@leonardocompany.com 	www.leonardocompany.com
LIFT EMOTION B.V.	info@lift-emotion.eu 	www.lift-emotion.eu
LIGURIA PRODUCE	info@liguriaproduce.com 	www.liguriaproduce.com
LINLEY	scr@davidlinley.com 	www.davidlinley.com
LIST GENERAL CONTRACTOR GMBH	mail@listgc.at 	www.listgc.at
LLOYD WERFT BREMERHAVEN GMBH	info@lloydwerft.com 	www.lloydwerft.com
LLOYD’S REGISTER	genoa-marine-business@lr.org 	www.lr.org/en/yachts
LNC MONACO	admin@lncmonaco.com 	www.lncmonaco.com
LOEVA	www.loeva.me
LUDWIG & DOMINIQUE EPV	contact@ludwingetdominique.com 	www.ludwingetdominique.com
LUFTHANSA TECHNIK  AG	clemens.schrettl@lht.dlh.de	www.lufthansa-technik.com/vip
LUIZ – INTERFROTTA BAD - UND HEIMTEXTILIEN GMBH	info@luiz.com 	www.luiz.com
LUMISHORE	info@lumishore.com 	www.lumishore.com
LUERSSEN	yachts@lurssen.com 	www.lurssen.com
LUERSSEN YACHTS	service@lurssen.com 	www.lurssen.com
LUSBEN	service@lusben.com  	www.lusben.com
LYBRA – LARGE YACHT BROKERS ASSOCIATION	sg@lybra.org 	www.lybra.org
LYNX YACHTS	info@lynxyachts.com 	www.lynxyachts.com
MAGNUS MARINE	sales@magnusmarine.com 	www.magnusmarine.com
MAISON DEL GUSTO YACHT PROVISIONING 	www.maisondelgusto.com
MAJESTY YACHTS	gci@gulfcraftinc.com 	www.gulfcraftinc.com
MAKEFAST	JackM@makefast.com 	www.makefast.com
MANGUSTA  YACHTS	info@mangustayachts.com 	www.mangustayachts.com
MANSON ANCHORS	info@mansonanchors.com 	www.mansonanchors.com
MANUFACTURE DE TAPIS DE BOURGOGNE  contact@manufacture-tapis-bourgogne.com  www.manufacture-tapis-bourgogne.com
MARBRERIE FOCHESATO	contact@marbrerie-fochesato.fr 	www.marbrerie-fochesato.fr
MARIN	info@marin.nl 	www.marin.nl
MARINA GENOVA	info@marinagenova.it 	www.marinagenova.it
MARINA IBIZA	info@marinaibiza.com 	www.marinaibiza.com
MARINA MILL	colin@marinamill.co.uk	www.extex.co.uk
MARINE LEATHER	marianna@marineleather.it	 	www.marineleather.it
MARINE RESOURCES RECRUITMENT Ltd	hi@marineresources.co.uk 	www.marineresources.co.uk
MARINE TRAVELIFT	sales@marinetravelift.com 	www.marinetravelift.com
MARINELEC TECHNOLOGIES	marinelec@marinelec.com 	www.marinelec.com
MARIOFF CORPORATION OY	info@marioff.fi 	www.marioff.com
MARITIME AND COASTGUARD AGENCY	large.yachts@mcga.gov.uk	www.ukshipregister.co.uk
MARITIME TRAINING ACADEMY	andrew.deere@mpigroup.co.uk	www.maritimetrainingacademy.com
MARMOR HOTAVLJE	info@m-h.si	www.marmor-hotavlje.si
MAXWELL MARINE	jmaurovich@maxwellmarine.com 	www.maxwellmarine.com
MAZU YACHTS BY OMV	info@omv.fr 	www.omv.fr
MB92 GROUP	info@mb92.com 	www.mb92.com
MC CLIC	mcclicmonaco@yahoo.fr	www.mcclic.com
MCMASTER YACHTS	info@mcmasteryachts.com 	www.mcmasteryachts.com
MEDYACHT	info@med-yacht.com 	www.med-yacht.com
MELITA MARINE GROUP	info@melitamarinegroup.net 	www.melitamarinegroup.net
MERLE WOOD & ASSOCIATES	mail@merlewood.com 	www.merlewood.com
MFB SOLICITORS	jwatson@m-f-b.co.uk 	www.m-f-b.co.uk
MIELE	info@miele.de 	www.miele.com
MILAN AUTOMOTIVE	office@milan-automotive.com 	www.milan-automotive.com
MONACAIR	info@monacair.mc 	www.monacair.mc/en
MONACO BOAT SERVICE	info@riva-mbs.com 	www.riva-mbs.com
MONACO MARINE	services@monacomarine.com 	www.monacomarine.com
MONACO TELECOM	monaco@telephone-europeen.mc 	www.monaco-telecom.mc
MONTE CARLO SOCIETY 	www.montecarlosbm.comluxury-trip-monaco/e-magazine-cario-society-2/
MONTE CARLO YACHTS	info@montecarloyachts.it 	www.montecarloyachts.it
MOONEN SHIPYARDS BV	info@moonen.com 	www.moonen.com
MORAN YACHT & SHIP	sales@moranyachts.com 	www.moranyachts.com
MR SMITH	sales@mrsmith.nl 	www.mrsmith.nl
MTU FRIEDRICHSHAFEN GMBH	info@mtu-online.com 	www.mtu-online.com
MUIR ENGINEERING	sales@muir.com.au 	www.muir.com.au
MULDER DESIGN	info@mulderdesign.nl 	www.mulderdesign.nl
MULDER SHIPYARD	info@muldershipyard.nl  	www.muldershipyard.nl
NAIAD DYNAMICS	sales@naiad.com 	www.naiad.com
NATIONAL MARINE SUPPLIERS	info@nationalmarine.com 	www.nationalmarine.com
NATURALMAT	mark@naturalmat.co.uk 	www.naturalmat.co.uk
NAUMATEC	m.vettori@naumatec.it 	www.naumatec.it
NAUTECH GROUP SHIPYARD	info@nautech-group.com 	www.nautech-group.com
NAUTOR’SWAN	info@nautorswan.com 	www.nautorswan.com
NAVANTIA SHIPREPAIRS	navantia@navantia.es 	www.navantia.es
NCA REFIT	info@ncarefit.com 	www.ncarefit.com
NEW ZEALAND MARINE 	info@bia.org.nz	www.nzmarine.com
NOBELCLEAN DIAMONDING SERVICE GMBH	info@nobelclean.com 	www.nobelclean.com
NOBISKRUG	yachts@nobiskrug.com 	www.nobiskrug.com
NORTH SAILS	lorraine.mckenna@northsails.com 	www.northsails.com
NORTHERN LIGHTS	info@northern-lights.com 	www.northern-lights.com
NORTHROP & JOHNSON	info@northropandjohnson.com 	www.northropandjohnson.com
NOVAMARINE	info@novamarine.it 	www.novamarine.it
OCEA	commercial@ocea.fr 	www.ocea-yachts.com/fr
OCEAN INDEPENDENCE	yachts@ocyachts.com	www.oceanindependence.com
OCEAN LED	lee.hirons@oceanled.com 	www.oceanled.com
OCEAN MAGAZINE	editor@oceanmedia.com.au 	www.oceanmagazine.com.au
OCEANAIR	salesenquiries@oceanair.co.uk 	www.oceanair.co.uk
OCEANCO	emy.artolli@oceanco.mc 	www.oceancoyacht.com
OCHRE	enquiries@ochre.net 	www.ochre.net/
OCULUS TECHNOLOGIES BV	info@oculustechnologies.nl 	www.oculustechnologies.nl
OLDENBURGER INTERIOR GMBH & CO.KG	info@oldenburger.com 	www.oldenburger.com
OLESINSKI Ltd	justin@olesinski.co.uk 	www.olesinski.co.uk
OMNIACCESS	fabian.gonzalez@omniaccess.com 	www.omniaccess.com
OMPECO	oksana.s@ompeco.it 	www.ompeco.com
ONDA TENDERS	info@ondatenders.com 	www.ondatenders.com
ONEOCEAN PORT VELL	reception@oneoceanportvell.com 	www.oneoceanportvell.com
ONLY YACHT	monaco@onlyyacht.com 	www.onlyyacht.com
OPACMARE S.R.L	info@opacmare.it 	www.opacmare.com
OPTONAVAL GMBH	hempel@optonaval.de 	www.optonaval.de
OT OLIVER TREUTLEIN GMBH	buchhaltung@olivertreutlein.com 	www.olivertreutlein.com
P&L studio	contact@plstudio.fr 	www.plstudio.fr
P&O MARINAS 	info@pandomarinas.com 	www.pandomarinas.com
PALAGI MARINE LIGHTS	info@palagi.it 	www.palagi.it
PALLADIUM TECHNOLOGIES INC	info@palladiumtechs.com 	www.palladiumtechs.com
PALUMBO SUPERYACHTS REFIT	info@palumbosy.com 	www.palumbosy.com
PANTAENIUS YACHT INSURANCE	monaco@pantaenius.com 	www.pantaenius.fr
PAOLA LENTI	s.asnaghi@paolalenti.it 	www.paolalenti.it
PASCOE INTERNATIONAL	sales@pascoeinternational.com 	www.pascoeinternational.com
PELLINI SPA	info@pellini.net 	www.pellininautica.net
PENDENNIS	info@pendennis.com 	www.pendennis.com
PENSUM LTD	marla@pensum.pro 	www.pensum.pro
PERENNIALS AND SUTHERLAND LLC.	samantha@davidsutherlandinc.com	www.perennialsandsutherland.com
PERINI NAVI	camilla.calza@perininavi.it 	www.perininavi.com
PESTO SEA GROUP	genova@pestoseagroup.com 	www.pestoseagroup.com
PERTER INSULL’S	yacht@insull.com 	www.insull.com
PHB DESIGN MANAGEMENT	contact@phb.paris.com 	www.phb.paris
PHILIPPE BRIAND LTD	pa@philippebriand.com 	www.philippebriand.com
PIANETA GEMME	amministrazione@pianetagemme.it 	www.pianetagemme.it
PIN-CRAFT SRL	info@pin-craft.com 	www.pin-craft.it
PINEL ET PINEL	info@pineletpinel.com 	www.pineletpinel.com
PINETTI SRL	info@pinetti.it 	www.pinetti.it
POLLARO CUSTOM FURNITURE	info@pollaro.com 	www.pollaro.com
PORT ADRIANO	info@portadriano.com 	www.portadriano.com
PORT DENARAU MARINA	reservations@denaraumarina.com 	www.denaraumarina.com
PORT DENIA	info@portdenia.com 	www.portdenia.com
PORT OF AMSTERDAM	info@portofamsterdam.com 	www.portofamsterdam.com
PORT TARRACO	manager@porttarraco.com 	www.porttarraco.com
PORTO MONTENEGRO	info@portomontenegro.com 	www.portomontenegro.com
PORTS TPM 	toulon@metropoletpm.fr	www.ports-tpm.fr
POSIDONIA	posidonia@posidonia.com 	www.posidonia.com
PRECIOSA	maritime@preciosa.com 	www.preciosalighting.com
PREMIER CATERING INTERNATION MONACO	lydia@premiercatering.fr 	               www.premiercatering.fr
PRIDE MEGA YACHT	pride@pridemegayachts.com 	www.pridemegayachts.com
PRINCESS YACHTS MONACO	info@princessyachtsmonaco.com 	www.princessyachtsmonaco.com
PRIVA BY GLOBAL EAGLE	priva@globaleagle.com 	www.priva.vip
PRIVATSEA	a.konidi@privatsea.com 	www.privatsea.com
PROTECTSTONE	info@protectstone.de 	www.protectstone.de
PSC NAUTIC SPA	webmaster@psc-engineering.it 	www.psc-nautic.com
QUANTUM MARINE STABILIZERS	kross@quantumstabilizers.com 	www.quantumstabilizers.com
RADIO ZEELAND DMP	sales@radiozeeland.com 	www.radiozeeland.com
RAFNAR	bjorn.jonsson@rafnar.is  	www.rafnar.is
RAYTHEON ANSCHUETZ	sales@raykiel.com	www.yacht.raytheon-anschuetz.com
RECKMANN YACHT EQUIPMENT GMBH	info@reckmann.com 	www.reckmann.com
RED SEA COLLECTION developed by the Public Investment Fund of Saudi Arabia	    info@redseacollection.sa        www.redseacollection.sa
RED SHARK EUROPE	hello@redsharkbikes.com 	 	www.redsharkbikes.com
REGISTRE INTERNATIONAL FRANCAIS	rif@developpement-durable.gouv.fr 	www.developpement-durable.gouv.fr
REINT JES GMBH	sales@reintjes-gears.de 	www.reintjes-gears.de
RIB X	colin@rib-x.co.uk 	www.rib-x.co.uk
RIBCO SA	sales@ribcomarine.com 	www.ribcomarine.com
RIBEYE	ella@ribeye.co.uk 	www.ribeye.co.uk
RINA	info@rina.org 	www.rina.org/en
RIVIERA INSIDER	secretariat@riviera-press.fr 	www.riviera-press.fr
RIVIERA RADIO	info@rivieraradio.mc 	www.rivieraradio.mc
RIVIERA YACHTING NETWORK	contact@rynetwork.com 	www.riviera-yachting-network.fr
RIVIERA ZEIT	secretariat@riviera-press.fr 	www.riviera-press.fr/#
ROBB REPORT USA	jodyd@robbreport.com 	www.robbreport.com
ROCHE BOBOIS	s.thomas@roche-bobois.com 	www.roche-bobois.com
ROLAND	info@roland-germany.de 	www.roland-germany.de
RONDAL BY	info@rondal.com 	www.rondal.com
ROSEMONT INTERNATIONAL	p.brigham@rosemont-mc.com 	www.rosemont-int.com
ROSEMONT YACHT SERVICES	contact@rosemont-mc.com	www.yachtownership-solution.com
ROSETTI SUPERYACHTS	consuelo.bentivogli@rosettisuperyachts.it 	www.rosettisuperyachts.it
ROSSINAVI	press@rossinavi.it 	www.rossinavi.it
ROYAL DECK	info@royaldeck.nl 	www.royaldeck.nl
ROYAL HUISMAN	yachts@royalhuisman.com 	www.royalhuisman.com
ROYAL YACHT BROKERS	office@royalyacht.com 	www.royalyacht-brokers.com
S&D YACHTS	mufy@sdyachts.com 	www.sdyachts.com
SA BAXTER	hardware@sabaxter.com 	 	www.sabaxter.com
SABRINA MONTE-CARLO	contact@sabrinamontecarlo.com 	www.sabrinamontecarlo.com
SACS MARINE MONACO	kenneth@sacsmarinemonaco.com 	www.sacsmarine.it
SAFEHAVEN INTERNATIONAL LIMITED	bach@safehaveninternational.com 	www.safehaveninternational.com
SAFINAH Ltd	rachel.coundon@safinah.co.uk 	www.safinah.co.uk
SAIM MARINE	info@saim-group.com 	www.saim-group.com
SANGUINETI CHIAVARI	info@sanguineti.com 	www.sanguineti.com
SANLORENZO	welcome@sanlorenzoyacht.com 	www.sanlorenzoyacht.com/en-us
SARP YACHTS	info@sarpyachts.com 	www.sarpyachts.com
SAVAGE MARINE LTD	info@savagelighting.co.uk 	www.savagelighting.co.uk 
SCHOTTEL	info@schottel.de 	www.schottel.de
SCORPION RIBS LTD	sales@scorpionribs.com 	www.scorpionribs.com
SEA VISION	sales@seavisioneurope.com 	www.seavision.com
SEABOB	info@seabob.com 	www.seabob.com
SEAir	flyingrib@seair.fr 	www.seair.fr
SEAMAGINE HYDROSPACE CORP	info@seamagine.com 	www.seamagine.com
SEANET	raf@seanetco.eu 	www.seanetco.eu/en
SEASATCOM	contact@seasatcom.com 	www.seasatcom.com/en
SEASTEMA	info@seastema.it 	www.seastema.it
SEBASTIEN BARRAU	contact@sebastienbarrau.com 	www.sebastienbarrau.com
SERDANELI	m.clavero@odiot.com	www.serdaneli.fr
SEVEN STARS MARINA & SHIPYARD	info@7starsms.eu	 	www.7starsms.eu
SEVENSTAR YACHT TRANSPORT	info@sevenstar-yacht-transport.com 	www.sevenstar-yacht-transport.com
SHELBY BY GENTLEMAN CAR	info@gentlemancar.com 	www.gentlemancar.com
SILVERLINING FURNITURE 	jason.chadda@silverliningfurniture.com    www.silverliningfurniture.com
SILVERYACHTS	info@silveryachts.com 	www.silveryachts.com
SIMRAD	roberto.sesenna@navico.com 	www.navico.com
SINOT EXCLUSIVE YACHT DESIGN 	info@sinot.com 	www.sinot.com
SKF MARINE GMBH	sales@skf-marine.com 	www.skf-marine.com
SKYTECH YACHTING	info@skytech-research.com 	www.skytech-research.com
SLEIPNER MOTOR	side-power@sleipner.no  	www.side-power.com
SLOOOW	info@slooow.eu 	www.slooow.eu
SMALLWOOD’S YACHTWEAR 	info@smallwoods.com 	www.smallwoods.com
SOCIETE GENERALE & SOCIETE GENERALE PRIVATE BANKING 	 sgbtmonaco@monaco377.com      www.privatebanking.societegenerale.mc/fr
SOUTHERN SPARS	press@southernspars.com 	www.southernspars.com
SOUTHERN WIND SHIPYARDS	pr@pegasoyd.com	www.sws-yachts.com
SPANOPOULOS SHIPYARDS	info@spanopoulos-group.com 	www.spanopoulos-group.com
SPRADLING EUROPE	a.paulsen@spradling.eu 	www.spradling.eu
STABLE	post@stable.no 	www.stable.no
STAJVELO	info@stajvelo.com 	www.stajvelo.com
STARK	sabine@stark1200.com 	www.stark1200.com
STP	info@stp-palma.com 	www.stp-palma.com
STROMER BIKE	info@stromerbike.com 	www.stromerbike.com
STUDIOART	info@studioart.it 	www.studioart.it
STURGE TAYLOR	dwilliams@sturgetaylor.com 	www.sturgetaylor.com
SUD MARINE SHIPYARD	motrap@sudmoteurs.fr 	www.sudmoteurs.fr
SUMMIT FURNITURE	info@summitfurniture.eu 	www.summitfurniture.com
SUNBRELLA DICKSON CONSTANT	europe@sunbrella.com 	www.sunbrella.com
SUNREEF YACHTS	info@sunreef-yachts.com 	www.sunreef-yachts.com
SUNSEEKER MONACO	lois@sunseeker.mc 	www.sunseeker.mc
SUPERYACHT AUSTRALIA	info@superyacht-australia.com 	www.superyacht-australia.com
SUPERYACHT BUILDERS ASSOCIATION-SYBass	info@sybass.org       www.sybass.org 	www.thesuperyachtlife.com
SUPERYACHT INDUSTRY NETWORK MALTA	gcutajar@cutrico.com	www.superyachtindustrymalta.com
SUPERYACHT IQ
SUPERYACHT SPARES	info@superyachtspares.com 	www.superyachtspares.com
SUPERYACHT TENDERS AND TOYS	info@superyachttendersandtoys.com 	www.superyachttendersandtoys.com
SUPERYACHT TIMES	info@superyachttimes.com 	www.superyachttimes.com
SUPERYACHT UK	Rselby@britishmarine.co.uk	www.superyachtuk.com
SUPERYACHTNEWS.COM	lulu@thesuperyachtgroup.com	www.superyachtnews.com
SUPERYACHTS.COM	info@superyachts.com 	www.superyachts.com
SWISS	swiss-marketing.france@dlh.de	www.swiss.com
SWISS THINKING 	michel@12thmanagement.com	www.swissthinking.ch
TAI PING	yacht@houseoftaiping.com	www.taipingyacht.com
TANKOA YACHTS	info@tankoa.com 	www.tankoa.it
TANSU	info@rizatansu.com 	www.rizatansu.com
TEAM ITALIA	info@team-italia.it 	www.team-italia.it
TECHNO GROUP	info-france@technogroup.net 	www.technogroup.net
TECNICOMAR S.P.A	info@tecnicomar.it 	www.tecnicomar.it
TERMOMECCANICA EOLO	eolo@termomeccanicaeolo.it 	www.termomeccanicaeolo.it
THE FINANCIAL TIMES	giulia.furlanello@ft.com 	www.ft.com
THE SUPERYACHT REPORT	justin@thesuperyachtreport.com 	www.thesuperyachtreport.com
THE WORLD OF YACHTS & BOATS	mail@theworldofyachts.com 	www.theworldofyachts.com
THG PARIS	contact@thg.fr	www.thg-paris.com/france/fr
TILSE GMBH	tiles@tilse.com 	www.tilse.com
TRANSPORT MALTA	yachtsmalta.tm@gov.mt	www.transport.gov.mt/superyacht-registration
TREND MARINE	sales@trendmarine.com 	www.trendsuperyacht.com
TRIBU	info@tribu.com 	www.tribu.com
TRIESTE REFITTING SYSTEM	info@trs-yacht.com 	www.trs-yacht.com
TRIPP DESIGN NAVAL ARCHITECTURE	krista@trippdesign.net 	www.trippdesign.net
TURNSTYLE DESIGNS	sales@turnstyledesingns.com 	www.turnstyledesingns.com
TURQUOISE YACHTS	main@turquoiseyachts.com 	www.turquoiseyachts.com
U-BOAT WORX	info@uboatworx.com 	www.uboatworx.com
UKSA	beverley-jo.fisher@uksa.org 	www.uksa.org
ULYSSE NARDIN	info@ulysse-nardin.ch 	www.ulysse-nardin.com
UMBRIA NAUTICAL CLUSTER	info@paolinispa.it 	www.paolinispa.it
VARADOR 2000	projects@varador2000.com 	www.varador2000.com
VBH	info@vbhi.com 	www.vbhi.com
VEDDER GMBH	vedder@vedder.net 	www.vedder.net
VEEM PROPELLERS	props@veem.com.au  	www.veempropellers.com
VEROB REFINED SURFACES	kontakt@verob.de 	www.verob.de
VERSARI & DELMONTE	info@versaridelmonte.com 	www.versaridelmonte.com
VERSILIA SUPPLY SERVICE SRL	info@versilia.it 	www.versilia.it
VETH PROPULSION	info@veth.net	www.vethpropulsion.com
VICRORY DESIGN	victory@victory.it 	www.victory.it
VIDEOWORKS	info@videoworksgroup.com 	www.videoworksgroup.com
VIKING RECRUITMENT LTD	info@vikingrecruitment.com 	www.vikingrecruitment.com
VIP LIMOUSINES	www.vip.mc
VIRAVER	sales@viraver.com 	www.viraver.com
VISTRA GROUP	anthony.galea@vistra.com 	www.vistra.com
VITTERS SHIPYARD	info@vitters.com 	www.vitters.com
VOITH	info@voith.com 	www.voith.com
VOLY Ltd	liz@voly.co.uk 	www.voly.co.uk
VPLP DESIGN	team@vplp.fr 	www.vplp.fr
VSY	info@vsy.it 	www.vsy.it
VULKAN	Joachim.wilkes@vulkan.com 	www.vulkan.com
WAJER YACHTS	dries@wajer.com 	www.wajer.com
WALLY	sales@wally.com 	www.wally.com
WARSASH SUPERYACHT ACADEMY	wsa@solent.ac.uk	www.warsashsuperyachtacademy.com
WAERTSILAE	elke.brunk@wartsila.com 	www.wartsila.com
WERNER YACHT DESIGN	theo@werneryachtdesign.com 	www.werneryachtdesign.com
WESTPORT	info@westportyachts.com 	www.westportyachts.com
WEST ISTANBUL MARINA	alexsandra@westistanbulmarina.com 	www.westistanbulmarina.com
WIDER	info@wider-yachts.com 	www.wider-yachts.com
WILLIAMS JET TENDERS LTD	sales@williamjettenders.com 	www.williamjettenders.com
WOLZ NAUTIC GMBH & CO.KG	info@wolznautic.de 	www.wolznautic.de/en
WREDE CONSULTING GMBH	info@wrede-consulting.com 	www.wrede-consulting.com
WYCC	info@wycc-insurance.com	www.wycc-insurance.com
XEAMOS CLEAR AIR ENGINEERING	info@xeamos.com  	www.xeamos.com
XTENDERS	jakkobien@xtenders.com 	www.xtenders.com
Y.CO	experience@y.co 	www.y.co
YACHT INVESTOR	info@yachtinvestor.com 	www.yachtinvestor.com
YACHT STYLE	gel@lux-inc.com	www.luxuo.com/category/motoring/yachting
YACHTCLOUD	roel@yachtcloud.eu 	www.yachtcloud.eu
YACHTGLASS	info@yachtglass.de 	www.yachtglass.de
YACHTING MATTERS	colinsquire@yachtingmatters.com	www.colinsquirepublishing.com
YACHTING PARTNERS INTERNATIONAL	info@ypigroup.com 	www.ypiyachts.com
YACHTLINE ARREDOMARE 1618 SPA	info@yachtline1618.com 	www.yachtline1618.com
YACHTNEEDS	info@yachtneeds.net 	www.yachtneeds.net
YACHTSIGN	info@yachtsign.com 	www.yachtsign.com
YACHTWERFT MEYER GMBH	info@yachtwerft-meyer.de 	www.yachtwerft-meyer.com
YACHTZOO	info@yacht-zoo.com 	www.yacht-zoo.com
ZENORO PREMIUM GENERATORS FOR SUPERYACHTS	info@zenoro.com 	www.zenoro.com
ZEPPELIN POWER SYSTEMS GmbH & Co. KG	lucie.nieder@zeppelin.com 	www.zeppelin-powersystems.com
ZF FRIEDRICHSHAFEN AG	postoffice@zf.com 	www.zf.com

ANTIGUA & BARBUDA TOURISM AUTHORITY	www.ab.gov.ag
AQUA MARINA	info@aquamarina.co.il 	www.aquamarina.co.il
BAHAMAS MINISTRY OF TOURISM	tourism@bahamas.com 	www.bahamas.com
BERNARD GALLAY Yacht Brokerage	www.bernard-gallay.com
BIC Ltd	info@bicgroup.lv 	www.bicaluminium.com
BOWERS & WILKINS BENELUX	www.bowers-wilkins.nl
CANTIERI DEGLI AREGAI	info@cantieridegliaregai.it 	www.cantieridegliaregai.it
CARLISLE BAY RESORT	info@carlisle-bay.com 	www.carlisle-bay.com
CITIZENSHIP BY INVESTMENT UNIT	info@cip.gov.ag 	www.cip.gov.ag
CRISTAL ET BRONZE	contact@cristal-et-bronze.com 	www.cristal-et-bronze.com
CROWN OF LIGHT	crownoflight@almod.com 	www.crownoflight.com
DREAMLINE YACHTS	welcome@dlyachtsdreamline.com 	www.dlyachtsdreamline.com
FALMOUTH HARBOUR MARINA	antiguafalmar@gmail.com 	www.antigua-marina.com
FRANKENTEK YACHT SECURITY	marc@frankentek.com	www.yachtsecurity.com
GLOBAL BANK OF COMMERCE	customer.service@gbc.ag	www.globalbank.ag
GORDON S. BLAIR	info@gordonblair.com 	www.gordonblair.com
HARNEYS	bvi@harneys.com 	www.harneys.com
HEMMELS	enquiries@hemmels.com 	www.hemmels.com
HILL & HILL	clients@lawhillandhill.com 	www.lawhillandhill.com
I.C. YACHT	ponzoni@icyacht.com 	www.icyacht.com
JMS YACHT MANAGEMENT & CREW SERVICES	hello@jmsyachting.com 	www.jmsyachting.com
KYMETA CORPORATION	dfotheringham@kymetacorp.com	www.kymetacorp.com
LAPIDIS	info@lapidis.org 	www.lapidis.org
LECHLER	info@lechler.eu 	www.lechler.eu
MAGIC YACHTS	www.magicyachts.com
MARTEK MARINE	info@martek-marine.com 	www.martek-marine.com
NET JETS EUROPE	mysenquiries@netjets.com 	www.netjetseurope.com
OYSTER YACHTS	enquiries@oysteryachts.com 	www.oysteryachts.com
SPEEDCAST	bart.noordhoek@speedcast.com 	www.speedcast.com
STOCKINGER SAFETY FIRST CLASS	info@stockinger.com 	www.stockinger.com
THOMPSON WESTWOOD	yachts@twwyachts.com 	www.twwyachts.com
TRITON SUBMARINES LLC	info@tritonsubs.com 	www.tritonsubs.com
VECO	info@veco.net 	www.veco.net
VP BANK	info@vpbank.li 	www.vpbank.com
XSHORE AB	info@xshore.com	www.xshore.com